R 800 800
NO ./Texture/1567106726159459734.xpm
SO ./Texture/MS.xpm
WE ./Texture/JR.xpm
EA ./Texture/KR.xpm
S  ./Texture/STAS.xpm
F 11,23,3
C 12,32,255

111111111111111111111111
100000000000000000000001
122222222220022222222221
122222222220022222222221
122222222220022222222221
12222222222002222222222111111111
12222222222010001000222222222211
12222222222002222222222111111111
111111111111111111111111
122222222220022222222221
122222222220022222222221
122222222220022222222221
122222222220022222222221
122222222220022222222221
10000000000N000000000001
111111111111111111111111
