R 1280 720
NO ./Texture/NO.xpm
SO ./Texture/SO.xpm
WE ./Texture/WE.xpm
EA ./Texture/EA.xpm
S  ./Texture/EA.xpm
 
F 102,178,255   
C 0,102,51

        1111111111111111111111111
        1000000000000000000000001
        10000000000000000020000011
        10000020000000000000000001
1111111110000000000000000000000011
100000000000000000001001000011111
10000000000100000000000000001
100000000001000W0001111101001
10000000001110000000010000001
10002000000000000000000000001
10000000000000000000000001001
10000001110000011100000000001
10000001 1000101 100000000001
11111111 1111111 111111111111
