R 1280 720
NO ./Texture/1567106726159459734.xpm
SO ./Texture/MS.xpm
WE ./Texture/JR.xpm
EA ./Texture/KR.xpm
S  ./Texture/STAS.xpm

F 102,178,255   
C 0,102,51	

1111
10N1
1111