R 1600 800 
NO ./Texture/1567106726159459734.xpm
SO ./Texture/MS.xpm
WE /Users/ncliff/Desktop/ncliff/cub3D/Texture/JR.xpm
EA        ./Texture/KR.xpm
                                S  Texture/pillar.xpm
C 124, 32, 1
F 11,23, 23

1111111111111111111111111
1000000000000000000000001
12222222222000222222222211111111111
12222222222000222222222211111    1
12222222222000222222222211111111111
122222222220002222222222111111111
122222222221010001000222222222211
122222222220002222222222111111111
1111111111100011111111111
1222222222200022222222221
1222222222200022222222221
1222222222200022222222221
1222222222200022222222221
122222222220002222222222111
100000000000N00000000001111
11111111111111111111111111111